wwwwwwwwwwwwwwwwwwwww
w.....0......0.w....w
w..0...wwwwwwwww.0..w
w......w............w
w......w.0..........w
w.0.......A.0www....w
www.....0......wwwwww
w.....w........w....w
w...wwwwwww.0..w....w
w..0w.....w...0...0.w
w...w.....w.........w
wwwwwwwwwwwwwwwwwwwww