wwwwwwwwwwwwwwwwwwwww
w...................w
w..0................w
w.........w.........w
w.........w.........w
w.........w.........w
w...wwwwwwwwwwww....w
w.........w.........w
w.........w......A..w
w.........w.........w
w.........0.........w
wwwwwwwwwwwwwwwwwwwww