wwwwwwwwwwwwwwwwwwwww
w...................w
w.....wwwwwwwww.....w
w.....w...0...w.....w
w.....w.......w.....w
w.....w....A..w.....w
w.....w.......w.....w
wwwwwww.......w.....w
w.....w.......w.....w
w.....w.....0.w.....w
wwww..w0......w...www
wwwwwwwwwwwwwwwwwwwww