wwwwwwwwwwwwwwwwwwwww
w...w0......w.......w
w...w..www..w.......w
w...w..www..w0......w
w...w......0w....0..w
w...w...............w
wwwww0..A...........w
w...................w
w......wwww.0.w.....w
w...0..w...0..w0....w
w......w......w.....w
wwwwwwwwwwwwwwwwwwwww