wwwwwwwwwwwwwwwwwwwww
w....w........w.....w
w....w........w.....w
w....w........w.....w
w.................g.w
w...................w
w...................w
wwwwwww.....w.......w
w.....w.....w.......w
w.c...w.....w....A..w
w.....w.....w.......w
wwwwwwwwwwwwwwwwwwwww