wwwwwwwwwwwwwwwwwwwww
w.........g.........w
w...c..www........c.w
w...................w
w..A................w
w...wwwww...........w
w...................w
w....wwwww..........w
w.g.............c...w
w....wwwww..........w
w...................w
wwwwwwwwwwwwwwwwwwwww