wwwwwwwwwwwwwwwwwwwww
w......c............w
w...................w
w.......A.w........gw
w........www........w
w.........w.........w
w...................w
w............c......w
w...................w
w.c.................w
w...................w
wwwwwwwwwwwwwwwwwwwww