wwwwwwwwwwwwwwwwwwwww
w.....wwwwwww....A..w
w...................w
w...................w
w...................w
w.....wwwwwww.......w
w.....w.............w
w.....w..........c..w
w.....w.............w
w.....wwwwwww...c...w
w...................w
wwwwwwwwwwwwwwwwwwwww