wwwwwwwwwwwwwwwwwwwww
www........A.......ww
ww...c..............w
w..............c....w
w.g............wwwwww
w.........c.........w
www.................w
w..................ww
www.................w
wc..................w
w...................w
wwwwwwwwwwwwwwwwwwwww