wwwwwwwwwwwwwwwwwwwww
w.........w.........w
w...................w
w.......A...........w
www.....ww.ww.....www
w...................w
w..........c........w
w...................w
w...g...............w
w.........w.........w
w.........w.........w
wwwwwwwwwwwwwwwwwwwww