wwwwwwwwwwwwwwwwwwwww
w...................w
w.......A......wwwwww
w.........w.........w
wwwww.....w.........w
w.........w.........w
w...................w
w...................w
w..............c....w
w...................w
w...................w
wwwwwwwwwwwwwwwwwwwww