wwwwwwwwwwwwwwwwwwwww
w.....wwwwwww....A..w
w...................w
w.......g...........w
w...................w
w.....wwwwwww.......w
w.....w.............w
w.....w.............w
w.....w.............w
w.....wwwwwww..c....w
w.................c.w
wwwwwwwwwwwwwwwwwwwww