wwwwwwwwwwwwwwwwwwwwwwwwwwwwww
wwww..........ddd........wwwww
w..n.n..n............n.n..n..w
w............................w
w............................w
w............................w
w............................w
w............................w
w............................w
w............................w
w............................w
w............A...............w
w.m.m.m.m.....vvv....m.m.m.m.w
w............wwwww...........w
wwwwwwwwwwwwwwwwwwwwwwwwwwwwww