wwwwwwwwwwwwwwwwwwwwwwwwwwwwww
wwwwwwwwwwwwwwwwwwwwwwwwwwwwww
wwww.........d.d.d.......wwwww
w.n........................n.w
w............................w
w.........wwwwwwwwwww........w
w............................w
w............................w
w............................w
w............................w
w...m.mmm....A.m......mmm.m..w
w.............m.m............w
w..wwwwwww...wwwww...wwwwww..w
wv...........wwwww..........vw
wwwwwwwwwwwwwwwwwwwwwwwwwwwwww