wwwwwwwwwwwwwwwwwwwwwwww
wwwwwwww...wdw...wwwwwww
wd.....w...w.w...w....dw
wwwwww.w...w.w...w.wwwww
w........n.....n.......w
w......................w
w......................w
w......................w
w......................w
w......................w
w......................w
w...........A..........w
w.....m.....m.....m....w
wv........wwwww.......vw
wwwwwwwwwwwwwwwwwwwwwwww