wwwwwwwwwwwwwwwwwwwwwwwwwwwwww
wwwwwwwwwwwwwwwwwwwwwwwwwwwwww
wwww.........ddddd.......wwwww
w............................w
w............................w
wn..........................nw
w............................w
w............................w
w............................w
w............................w
w...mmmm....A..........mmmm..w
w.............mmm............w
wwwwwwwwww...wwwww...wwwwwwwww
w............wwwww...........w
wwwwwwwwwwwwwwwwwwwwwwwwwwwwww