wwwwwwwwwwwwwwwwwwwwwwwwwwwwww
wwwwwwwwwwwwwwwwwwwwwwwwwwwwww
wwww.......dddddddd......wwwww
w............................w
w............................w
wn..........................nw
w............................w
w............................w
w............................w
w............................w
w.m.m.m.m....A.......m.m.m.m.w
w.............mmm............w
w...wwwwww...wwwww...wwwww...w
wv...........wwwww..........vw
wwwwwwwwwwwwwwwwwwwwwwwwwwwwww