wwwwwwwwwwwww
w..........gw
w....w......w
w.w.w..1....w
w+w.........w
ww3..3..2...w
w..w..w.w.w.w
w...A.......w
wwwwwwwwwwwww