wwwwwwwwwwwwwwwww
w......x........w
w...............w
wbbb.........bbbw
w...............w
w...............w
w......A........w
w...............w
w....ccccc......w
w...............w
w...............w
w....z.z.z......w
wfffffffffffffffw
w.....a.....a...w
w...............w
w...............w
wwwwwwwwwwwwwwwww