wwwwwwwwwwwwwwwwww
w........a.......w
w......w.........w
w......w.........w
w..x...w......a..w
w......w.........w
w......www.......w
w..A.............w
www...x..........w
wwwwwwwwwwwwwwwwww