wwwwwwwwwwwwwwwwwwwwwwwwwwwwww
w...........bba.b............w
w........a..fbbbb............w
w..........afff..............w
w............................w
w..x.........................w
w.......................a.bbbw
w..z.......ccccc..........ba.w
w...................a.....b..w
w............................w
w..A...w.......b........ff...w
www....w............x........w
w............................w
w.........z..................w
wwwwwwwwwwwwwwwwwwwwwwwwwwwwww