wwwwwwwwwwwwwwwwwwwwwwwwwwwwww
w............................w
w........b...................w
w..................a.........w
w............................w
w............................w
w..b........m................w
w..............A.............w
w....fffff...................w
w...fx.x..f..................w
w...f.....f..................w
w....fffff....a...b......b...w
w...........................ww
w...........................ww
wwwwwwwwwwwwwwwwwwwwwwwwwwwwww