wwwwwwwwwwwwwwwwwwwwwwwwwwwwww
w............................w
w............................w
w...faa.......af.............w
w...ffff.....fff.......bb....w
w.........c...............z..w
w..............a.............w
w..x.............c...........w
w..........b.................w
w................c..a........w
w..A.....a.....b.............w
w............................w
w............................w
www........z........x........w
wwwwwwwwwwwwwwwwwwwwwwwwwwwwww