wwwwwwwwwwwwwwwwwwwwwwwwwwwwww
w............................w
w........b...................w
w..................a.........w
w..................fffff.....w
w.................fx....f....w
w..b........m.....f..x..f....w
w..............A...fffff.....w
w............................w
w............................w
w........w...................w
w......w......a...b......b...w
w............................w
w............................w
wwwwwwwwwwwwwwwwwwwwwwwwwwwwww