wwwwwwwwwwwwwwwwwwwwwwwwwwwwww
w............................w
w...........fba.bf...........w
w........a..fbbbbf...........w
w..........a..ff.............w
w..x.........................w
w.......................a....w
wbbb.........................w
w.a.b................a.......w
w...b........................w
w..A...w.......b........ff...w
www....w............x........w
w..........c.................w
w................z...........w
wwwwwwwwwwwwwwwwwwwwwwwwwwwwww