wwwwwwwwwwwwwwwwwwwwwwwwwwwwww
w.........................x..w
w............................w
w.............b..............w
w................cccccc......w
w................c..a.c......w
w..b........m....c....c......w
w..............A.cccccc......w
w...fffff....................w
w...fx.xf....................w
w...f...f...bbb..............w
w...fffff...bab...b......b...w
w...........bbb..............w
www..........................w
wwwwwwwwwwwwwwwwwwwwwwwwwwwwww