wwwwwwwwwwwwwwwwwwwwwwwwwwwwww
w............................w
w............................w
w...faaf.....................w
w...ffff...........a...bb....w
w............................w
w..............a.............w
w..x.........................w
w..........b.................w
w...................a........w
w..A.....a.....b.............w
w............................w
www.................x........w
wwwwwwwwwwwwwwwwwwwwwwwwwwwwww