wwwwwwwwwwwwwwwwwwwww
w.x.................w
w...a.....a.........w
w............a......w
w...................w
w...b..........a....w
w........a..........w
w..A..b..........b..w
wwwx................w
wwwwwwwwwwwwwwwwwwwww