wwwwwwwwwwwwwwwwwwwww
w..........w........w
w.......g..w........w
w..........w........w
w........w.......+..w
w........w..........w
w........w..........w
w...................w
w...................w
w.....A.............w
w...................w
wwwwwwwwwwwwwwwwwwwww