wwwwwwwwwwwwwwwwwwwww
w..........w........w
w.........+w....A...w
w.......www.........w
w.......2...........w
w........3..........w
w............wwwwwwww
w....2..............w
w.......wwww........w
w.........gw........w
w..........w........w
wwwwwwwwwwwwwwwwwwwww