wwwwwwwwwwwwwwwwwwwww
w..........w........w
w.......g..w........w
w...................w
w..........w........w
w..........w.....+..w
w...................w
w...................w
w........A.w........w
w...3..........w....w
w...................w
wwwwwwwwwwwwwwwwwwwww