wwwwwwwwwwwwwwwwwwwww
w..........w........w
w..........w.....A..w
w.......wwww........w
w..........3........w
w.............wwwwwww
w....2........g.....w
w.......wwww........w
w.........+w...1....w
w..........w........w
w..........w........w
wwwwwwwwwwwwwwwwwwwww