wwwwwwwwwwwwwwwwwwwww
w..........w........w
w..........wg.......w
w..........wwwww....w
w.......3...........w
w..............wwwwww
w..................+w
w..........w........w
w...................w
w..........w...3....w
wA.........w........w
wwwwwwwwwwwwwwwwwwwww