wwwwwwwwwwwwwwwwwwwww
w.........gw...A....w
w.......wwww........w
w..........3........w
wwwwwww...........+.w
w........3..........w
w...2...............w
w.......wwww........w
w.......2..w.....1..w
w..........w........w
w..........w........w
wwwwwwwwwwwwwwwwwwwww