wwwwwwwwwwwwwwwwwwwww
w...................w
w....hh.....ww...x..w
w....ww.....whh.....w
w.....w.....www.....w
w.....w..A....wh....w
w...wwh.......wh....w
w...w.........w.....w
w..........wwww.....w
w...................w
we..................w
wwwwwwwwwwwwwwwwwwwww