wwwwwwwwwwwwwwwwwwwww
w......w............w
w..x...w............w
w......w............w
w......w............w
w......wwwwwwwwwwwwww
w...................w
w...................w
w...................w
w...................w
w.......A..........ew
wwwwwwwwwwwwwwwwwwwww