wwwwwwwwwwwwwwwwwwwww
w...................w
w...............e...w
w...................w
w..wwwwwwww.......www
w..wwwwwwwwwwwwwwwwww
w.......A...........w
w...................w
w.....wwwwww........w
w.....w....w........w
w.....w.x..w........w
wwwwwwwwwwwwwwwwwwwww