wwwwwwwwwwwwwwwwwwwww
w...................w
w..x................w
w...................w
w...................w
wwwwwwwwwwwwwwwwwwwww
w...................w
w...................w
w...................w
w................e..w
w.......A...........w
wwwwwwwwwwwwwwwwwwwww