wwwwwwwwwwwwwwwwwwwww
w..........ww.......w
w..........ww.......w
w.0m....mmmww.......w
wwg0m...w00kw.......w
w.0m....wwwww.......w
w.......1...1.......w
w1...1...A..........w
w..............wwwwww
w..1...........w....w
w..............w..k.w
wwwwwwwwwwwwwwwwwwwww