wwwwwwwwwwwwwwwwwwwww
w.........k.........w
w...A.........1.....w
w...................w
w.......1...........w
w...................w
wwwwwwwwww0wwwwwwwwww
w...................w
w...................w
w..g.......mmmmmmm..w
w...................w
wwwwwwwwwwwwwwwwwwwww