wwwwwwwwwwwwwwwwwwwww
w...A...m...........w
w...................w
w...............g...w
w...................w
w...................w
w...................w
w...................w
w..m................w
w............k......w
w...................w
wwwwwwwwwwwwwwwwwwwww