wwwwwwwwwwwwwwwwwwwww
w.......A...........w
w...................w
w..............k....w
w...................w
w...................w
w...................w
w...................w
w...................w
w..g................w
w...................w
wwwwwwwwwwwwwwwwwwwww