wwwwwwwwwwwwwwwwwwwww
w...........a.......w
w...................w
w.........w.........w
w.........w.........w
w..x......w......a..w
w.........w.........w
w.........www.......w
w...................w
w..A................w
www......x..........w
wwwwwwwwwwwwwwwwwwwww