wwwwwwwwwwwwwwwwwwwww
w.x.................w
w...a.....a.......A.w
w............a......w
w...................w
w...................w
w...b..........a....w
w...................w
w........a..........w
w.....b..........b..w
wwwx................w
wwwwwwwwwwwwwwwwwwwww