wwwwwwwwwwwww
w..Kw...w...w
w...w...w...w
w...w.t.w...w
wwwwwwwwwwwww
w...w.c.w...w
w...w...w..Aw
w...w...w.c.w
wwwwwwwwwwwww
w...w...w..xw
w...wc..w...w
w...w...w...w
wwwwwwwwwwwww
