wwwwwwwwwwwww
w...w...D...w
w...w.K.w.x.w
w...wA..w...w
wwwwwwwwwwwww
w...w.t.w...w
w...w...wc..w
w..kw...w...w
wwdwwwwwwwwww
w...w...w...w
w...w...w...w
w...w...w...w
wwwwwwwwwwwww
