wwwwwwwwwwwww
w...w...w.F.w
w...w...w...w
w...w...w...w
wwwwwwwwwwwww
w...w..Tw...w
w...w.A.w...w
w...w...wS..w
wwwwwwwwwwwww
w...w.T.w...w
w...w...w...w
w.e.w.x.w.c.w
wwwwwwwwwwwww
