wwwwwwwwwwwww
w..Pw...w...w
w...w...wc..w
w...w...w...w
wwwwwwwwwwwDw
w.c.G...w...w
wt..wT..w...w
w...wSAkwKT.w
wwwwwwwwwwwww
w...w...d...w
w...w...w..xw
we..w...wP..w
wwwwwwwwwwwww
