wwwwwwwwwwwwwwwwwwwwwwwwwwwwww
w......ww...wwwww............w
w......ww...wwwww........ww..w
w......ww...wwwww......ww....w
w.x....ww...www........ww....w
w....wwww....ww..............w
w..wwww.......www............w
w..ww.........www............w
w.............www............w
w......www....www............w
w.......ww......www..........w
w.......ww......www..........w
w..w....ww......www..........w
w.......A...............e....w
wwwwwwwwwwwwwwwwwwwwwwwwwwwwww