wwwwwwwwwwwwwwwwwwwwwwwwwwwwww
w......ww...wwwww............w
w......ww...wwwww........e...w
w......ww....................w
w......ww.....www.......ww...w
w..hhwwww....hwww.......ww...w
w..wwww......hwww............w
w..ww........hwww............w
w.............www........w...w
w.............www........w...w
w......hhw......www......w...w
w......www......www......w...w
w...x..www......www......w...w
w.......A....................w
wwwwwwwwwwwwwwwwwwwwwwwwwwwwww