wwwwwwwwwwwwwwwwwwwwwwwwwwwwwwwwwww
w...............w.......wh........w
w..e.....wwwwwwww.......wwww......w
w........whhhhhhh.........w.......w
w........w........................w
wwwwwwwwww......wwwwwwwwwwwwwwwwwww
w...............whw.....whw.......w
w.........w.w...whw.....whw.......w
w.......A...w...whw.....whw.......w
w...........w...www.....wwx.......w
wwwwwwwwwwwwwwwwwwwwwwwwwwwwwwwwwww