wwwwwwwwwwwwwwwww
w.....wgw.......w
wwwwww...wwwwwwww
w.....w.A.w.....w
w...............w
w..1.........1..w
w...............w
w...............w
wwwwwww.0.wwwwwww
w......w0w......w
w......wkw......w
wwwwwwwwwwwwwwwww