wwwwwwwwwwwww
w...wkw.....w
w...w000....w
w...w0m01...w
w....0111...w
w.....1A1...w
w....01.1...w
w..1........w
w...........w
w....wwwg...w
wwwwwwwwwwwww