wwwwwwwwwwwwwwwwwww
w......wwwww......w
w..1...wwwww...1..w
w......00.00......w
w..w.1.00k00.1.w..w
w..w...00000...w..w
w..1...00m00...1..w
w..w...ww1ww...w..w
w.................w
w.................w
w..wwwwww1wwwwww..w
w........Ag.......w
w.................w
wwwwwwwwwwwwwwwwwww