wwwwwwwwwwwwwwwwwwwwwwwwww
wA.......................w
w.......t........t.......w
w........................w
w........................w
w....................a...w
w..........a.............w
w........................w
w.........aaaaa..........w
wwwwwwwwwwwwwwwwwwwwwwwwww
