wwwwwwwwwwwwwwwwwwwwwwwwww
wA..p....................w
w................c.......w
w......t.....a...........w
wwww.....................w
w.aw.................a...w
w.ww.......a.............w
w..............c.........w
w....................t...w
wwwwwwwwwwwwwwwwwwwwwwwwww
